11111111111111111
10000000000C10C01
1011111C111110101
101C0000000000001
10111111111010101
100C00000P00C01E1
11111111111111111