111111
1P0C11
1C1111
110E11
111111
//
RM => i : line, j : clone;
//
111111
1V0C11
1C1111
110E11
111111

//exmpe de map
11111111111111111
1P000000000C10C01
1011111C111110101
101C0000000000001
10111111111010101
100C00000000C01E1
11111111111111111
//autre exmple
111111111111111111
1P0001000000000001
101011101111111101
101000000000000001
101111111111111101
100000000C000000E1
111111111111111111

//
1111111111111111111111111111
1P00000C000000C00000C00000C1
1011110101111010111101011011
10000C010000001000000C000001
1011101110111011101110111011
1C00001C00000000C0001C0000C1
10111010111C1011101011101011
10000C10000010000010C00010E1
1011101011101011101011101011
1C00001C00000000C0001C0000C1
10111010111C1011101011101011
10000C10000010000010C0001001
1011101011101011101011101011
1C0X000C000000C000000C0000C1
1111111111111111111111111111
//
1111111111111111111111111111
1P00000C000000C00000C00000C1
1011110101111010111101011011
10000C010000001000000C000001
1011101110111011101110111011
1C00001C00000000C0001C0000C1
10111010111C1011101011101011
10000C10000010000010C00010E1
1011101011101011101011101011
1C00001C00000000C0001C0000C1
10111010111C1011101011101011
10000C10000010000010C0001001
1011101011101011101011101011
1C00000C000000C000000C000XC1
1111111111111111111111111111