11111111111
11P00000001
100C0E00001
1X000000001
11111111111