11111111111
11PE0000001
1XC00000001
1C000000001
11111111111