111111111111111111
100001000000000001
101011101111111101
1010000P0000000001
101111111111111101
100000000C000000E1
111111111111111111