111111111111111111
100100000C00000001
1000P000C000000001
1000C0C0C0C0000001
1000C0C0C0C0000001
1000C0C000C0000001
1000C0C0C0C00000E1
111111111111111111