11111111
11100111
11P0C0E1
11C01101
10C00001
11111111