1111111111111111111111111111
1P00000C000000C00000C00000C1
1011110101111010111101011011
10000C010000001000000C000001
1011101110111011101110111011
1C00001C00000000C0001C0000C1
10111010111C1011101011101011
10000C10000010000010C00010E1
1011101011101011101011101011
1C00001C00000000C0001C0000C1
10111010111C1011101011101011
10000C10000010000010C0001001
1011101011101011101011101011
1C00000C000000C000000C0000C1
1111111111111111111111111111