111111
1P0C11
1C1111
110E11
111111
//
RM => i : line, j : clone;
//
111111
1V0C11
1C1111
110E11
111111

//exmpe de map
11111111111111111
1P000000000C10C01
1011111C111110101
101C0000000000001
10111111111010101
100C00000000C01E1
11111111111111111
//autre exmple
111111111111111111
1P0001000000000001
101011101111111101
101000000000000001
101111111111111101
100000000C000000E1
111111111111111111