11111111111
1EP00000001
1XC00000001
1C000000001
11111111111