11111111
11100111
11P0C1E1
1CC01101
1C100001
11111111